AtemfrequenzSoll    UMETA(DisplayName = "AtemfrequenzSoll"),
Atemfrequenz UMETA(DisplayName = "Atemfrequenz"),
Atemzugvolumen UMETA(DisplayName = "Atemzugvolumen"),
Atemminutenvolumen UMETA(DisplayName = "Atemminutenvolumen"),
pO2 UMETA(DisplayName = "pO2"),
SpO2 UMETA(DisplayName = "SpO2"),
FiO2 UMETA(DisplayName = "FiO2"),
pCO2 UMETA(DisplayName = "pCO2"),
Lungenperfusion UMETA(DisplayName = "Lungenperfusion"),
Herzfrequenz UMETA(DisplayName = "Herzfrequenz"),
Schlagvolumen UMETA(DisplayName = "Schlagvolumen"),
Herzzeitvolumen UMETA(DisplayName = "Herzzeitvolumen"),
HerzzeitvolumenBedarf UMETA(DisplayName = "HerzzeitvolumenBedarf"),
Gesamtvolumen UMETA(DisplayName = "Gesamtvolumen"),
Fluessigkeitsreserve UMETA(DisplayName = "Fluessigkeitsreserve"),
Blutverlust UMETA(DisplayName = "Blutverlust"),
ZellulaereBlutmenge UMETA(DisplayName = "ZellulaereBlutmenge"),
Haemoglobin UMETA(DisplayName = "Haemoglobin"),
Haematokrit UMETA(DisplayName = "Haematokrit"),
MAD UMETA(DisplayName = "MAD"),
TPR UMETA(DisplayName = "TPR"),
Perfusionsdefizit UMETA(DisplayName = "Perfusionsdefizit"),
SerumLaktat UMETA(DisplayName = "SerumLaktat"),
InfektlastGewebe UMETA(DisplayName = "InfektlastGewebe"),
InfektlastBlut UMETA(DisplayName = "InfektlastBlut"),
APR UMETA(DisplayName = "APR"),
Temperatur UMETA(DisplayName = "Temperatur"),
FieberPeakwert UMETA(DisplayName = "FieberPeakwert"),
GlomerulaereFiltrationsrate UMETA(DisplayName = "GlomerulaereFiltrationsrate"),
GFR UMETA(DisplayName = "GFR"),
Creatinin UMETA(DisplayName = "Creatinin"),
Bicarbonat UMETA(DisplayName = "Bicarbonat"),
pHWert UMETA(DisplayName = "pHWert"),
BaseExcess UMETA(DisplayName = "BaseExcess"),
Kalium UMETA(DisplayName = "Kalium"),
Thrombozyten UMETA(DisplayName = "Thrombozyten"),
Thromboplastinzeit UMETA(DisplayName = "Thromboplastinzeit"),
PartielleThromboplastinzeit UMETA(DisplayName = "PartielleThromboplastinzeit"),
Gerinnung UMETA(DisplayName = "Gerinnung"),
Fibrinolyse UMETA(DisplayName = "Fibrinolyse"),
Quickwert UMETA(DisplayName = "Quickwert"),
DOAK UMETA(DisplayName = "DOAK"),
DDimer UMETA(DisplayName = "DDimer"),
Bilirubin UMETA(DisplayName = "Bilirubin"),
AP UMETA(DisplayName = "AP"),
GGT UMETA(DisplayName = "GGT"),
ALT UMETA(DisplayName = "ALT"),
AST UMETA(DisplayName = "AST"),
Lipase UMETA(DisplayName = "Lipase"),
Amylase UMETA(DisplayName = "Amylase"),
Exsudationsrate UMETA(DisplayName = "Exsudationsrate"),
ExsudationExtremitaeten UMETA(DisplayName = "ExsudationExtremitaeten"),
ExsudationAbdomen UMETA(DisplayName = "ExsudationAbdomen"),
ExsudationPleural UMETA(DisplayName = "ExsudationPleural"),
Plasmavolumen UMETA(DisplayName = "Plasmavolumen"),
Protonenkonzentration UMETA(DisplayName = "Protonenkonzentration"),
IntraabdominellerDruck UMETA(DisplayName = "IntraabdominellerDruck"),
Leberfunktion UMETA(DisplayName = "Leberfunktion"),
Nierenfunktion UMETA(DisplayName = "Nierenfunktion"),
Pankreasfunktion UMETA(DisplayName = "Pankreasfunktion"),
Leukozyten UMETA(DisplayName = "Leukozyten"),
MCV UMETA(DisplayName = "MCV"),
MCH UMETA(DisplayName = "MCH"),
MCHC UMETA(DisplayName = "MCHC"),
Natrium UMETA(DisplayName = "Natrium"),
LDH UMETA(DisplayName = "LDH"),
GPT UMETA(DisplayName = "GPT"),
CRP UMETA(DisplayName = "CRP"),
PankreatitisAPR UMETA(DisplayName = "PankreatitisAPR"),
Gallenstau UMETA(DisplayName = "Gallenstau"),
InfektlastTuberkulose UMETA(DisplayName = "InfektlastTuberkulose"),
Schmerzlevel UMETA(DisplayName = "Schmerzlevel"),
TroponinBase UMETA(DisplayName = "TroponinBase"),
CKBase UMETA(DisplayName = "CKBase"),
CKMBBase UMETA(DisplayName = "CKMBBase"),
Myokardschaden UMETA(DisplayName = "Myokardschaden"),
Troponin UMETA(DisplayName = "Troponin"),
CK UMETA(DisplayName = "CK"),
CKMB UMETA(DisplayName = "CKMB"),
FaktorHerzinfarkt UMETA(DisplayName = "FaktorHerzinfarkt"),
MaxSchlagvolumen UMETA(DisplayName = "MaxSchlagvolumen"),
MaxHerzfrequenz UMETA(DisplayName = "MaxHerzfrequenz"),
AVBlock UMETA(DisplayName = "AVBlock"),
BaseMaxHerzfrequenz UMETA(DisplayName = "BaseMaxHerzfrequenz"),
PulmonaleEntzuendung UMETA(DisplayName = "PulmonaleEntzuendung"),
GAF UMETA(DisplayName = "GAF"), //Gasaustauschflaeche
RespE UMETA(DisplayName = "RespE"), //respiratorische Erschoepfung
MaxAtemzugvolumen UMETA(DisplayName = "MaxAtemzugvolumen"),
MinAtemfrequenz UMETA(DisplayName = "MinAtemfrequenz"),
MaxAtemfrequenz UMETA(DisplayName = "MaxAtemfrequenz"),
MinAtemzugvolumen UMETA(DisplayName = "MinAtemzugvolumen"),
Beatmungsdruck UMETA(DisplayName = "Beatmungsdruck"),
MaxInfektlastBlut UMETA(DisplayName = "MaxInfektlastBlut"),
MaxInfektlastGewebe UMETA(DisplayName = "MaxInfektlastGewebe"),
NTProBNP UMETA(DisplayName = "NTProBNP"),
ToxScreen UMETA(DisplayName = "ToxScreen"),
MaxCreatinin UMETA(DisplayName = "MaxCreatinin"),
Procalcitonin UMETA(DisplayName = "Procalcitonin"),
Ferritin UMETA(DisplayName = "Ferritin"),
Neutrophile UMETA(DisplayName = "Neutrophile"),
Eosinophile UMETA(DisplayName = "Eosinophile"),
Basophile UMETA(DisplayName = "Basophile"),
Lymphozyten UMETA(DisplayName = "Lymphozyten"),
Monozyten UMETA(DisplayName = "Monozyten"),
PEEP UMETA(DisplayName = "PEEP"),
NVLA UMETA(DisplayName = "NVLA"),
PEEPvsNVLA UMETA(DisplayName = "PEEPvsNVLA"),
Diffusion UMETA(DisplayName = "Diffusion"),
Bewusstsein UMETA(DisplayName = "Bewusstsein"),
Beatmungsfrequenz UMETA(DisplayName = "Beatmungsfrequenz"),
ViraleAPR UMETA(DisplayName = "ViraleAPR"),
KapillaereFuellungszeit UMETA(DisplayName = "KapillareFuellungszeit"),
TSH UMETA(DisplayName = "TSH"),
Harnabflussstoerung UMETA(DisplayName = "Harnabflussstoerung"),
Calcium UMETA(DisplayName = "Calcium"),
Phosphat UMETA(DisplayName = "Phosphat"),
Harnstoff UMETA(DisplayName = "Harnstoff"),
Albumin UMETA(DisplayName = "Albumin"),
Protein UMETA(DisplayName = "Protein"),
INR UMETA(DisplayName = "INR"),
Fibrinogen UMETA(DisplayName = "Fibrinogen"),
Erythrozyten UMETA(DisplayName = "Erythrozyten"),
AntiGBM UMETA(DisplayName = "Anti-GBM-Antikoerper"),
ANA UMETA(DisplayName = "ANA"),
ANCA UMETA(DisplayName = "ANCA"),
pANCA UMETA(DisplayName = "pANCA"),
MPO UMETA(DisplayName = "MPO"),
cANCA UMETA(DisplayName = "cANCA"),
PR3 UMETA(DisplayName = "PR3"),
Blutbild UMETA(DisplayName = "Blutbild"),
DiffBlutbild UMETA(DisplayName = "Differential-Blutbild"),
Chlorid UMETA(DisplayName = "Chlorid"),
Glucose UMETA(DisplayName = "Glucose"),
Pulsamplitude UMETA(DisplayName = "Pulsamplitude"),
